11111111111
10E001100N1
101CC1100C1
1011111C001
1P000111101
1000011C001
10010110111
1001E110111
10000110011
1001111C0C1
1001C111101
1C000110001
10111110C01
101CC110001
1000N11CCC1
11111111111