11111111111111111111
1C0000P00000C00000E1
11111111111111111111
