111111111111111
10000PCE0000001
100000000000001
111111111111111